----------
-------*--
-------*--
-------*--
-------*--
-------*--
----------
---*------
---*------
---*------
--*-------
--*-------
--*-------
----------
-----P----